TILE 1 2 0
TILE 0 3 0
TILE 2 4 0
TILE 2 2 1
TILE 3 1 2
TILE 0 9 0
TILE 0 10 0